NO textures/kirby.xpm
EA textures/mon_amour_seg_roy_de_mon_coeur.xpm
WE textures/simple_tiles.xpm
SO textures/wall.xpm

F 0,0,1
C 225,30,0




1111111111111111111111111111111111111111111111111111111111111111111111111111111111111111111111111111
1111111111111111111111111111111111111111111111111111111111111100000000000000111111111111111111111111
1111111111111111111111111111111111111111111111111111111111111110000000000000000000001111111111111111
1111111111111111111111111111111111111111111111111111111110000000000000000000000000000011111111111111
1111111111111111111111111111111111111111111111111111100000000000000000000000000000000001111111111111
1111111111111111111111111111111111111111111111111110000000000000000000000000000000000000111111111111
1111111111111111111111111111111111111111111111111000000000000000000000000000000000000000011111111111
1111111111111111111111111111111111111111111111111000000000000000000000000000000000000000001111111111
1111111111111111111111111111111111111111111111110000000000000000000000000000000000000000000111111111
1111111111111111111111111111111111111111111111110000000000000000000000000000000000000000000111111111
11111111111111111111111111111111111111111111111100000000000000N0000000000000000000000000000011111111
1111111111111111111111111111111111111111111111111110000000000000000000000000000000000000000011111111
1111111111111111111111111111111111111111111111111111100000000000000000000000000000000000000001111111
1111111111111111111111111111111111111111111111111111100000000000000000000000000000000000000001111111
1111111111111111111111111111111111111111111111111111111000000000000000000000000000000000000001111111
1111111111111111111111111111111111111111110111111111111110000000000000000000000000000000000001111111
1111111111111111111111111111111111111110000000000011111111000000000000000000000000000000000001111111
1111111111111111111111111111111111111000000000000001111111100000000000000000000000000000000001111111
1111111111111111111111111111111111110000000000000000111111100000000000000000000000000000000001111111
1111111111111111111111111111111111110000000000000000111111110000000000000000000000000000000001111111
1111111111111111111111111111111111110000000000000000011111110000000000000000000000000000100100111111
1111111111111111111111111111111111111000000000000000001111110000000000000000000000000000110011111111
1111111111111111111111111111111111111110000000000000000011100000000000000000000000000000111111111111
1111111111111111111111111111111111111111110000000000000000000000000000000000000000001000111111111111
1111111111111111111111111111111111111111100000000000000000000000000000000000000000000110111111111111
1111111111111111111111111111111111111111000000000000000000000000000000000000000000000111111111111111
1111111111111111111111111111111111111111000000000000000000000000000000000000000000000011111111111111
1111111111111111111111111111111111111111000000000000000000000000000000000000000000000001111111111111
1111111111111111111111111111111111111111000000000000000000000000000000000000000000000001111110001111
1111111111111111111111111111111111111110000000000000000000000000000000000000000000000000000000011111
1111111111111111111111111111111111111111111111111111111111111111111111111111111111111111111111111111
