NO textures/simple_tiles.xpm
SO textures/simple_tiles.xpm
WE textures/simple_tiles.xpm
EA textures/simple_tiles.xpm

F 0,0,1
C 225,30,0

111111111111111111111111111111111111111111111111111111111
100000000000000000000000000000000000000000000000000000001
100000011111111111100000000111111111111100000000000000001
100000110000000011000000011000000000011000000000000000001
100000100000000001000000100000000000001000000000011111111
100000100000000001000000100000000000001000000000100000001
100000100000111101000000100001111110001000000000100000001
100000100001000001000000100010000010001000000000100000001
100000100010000010000000100100000001001000000000100000001
100000100100000100111111101000000000101111111000100000001
100000101000001000100000001000000000010000001100100000001
100000100100010000100000001000000000010000000010100000001
100000100010100000100000001000000000010000000001000000001
100000100001000000100000001000000000010000000000100000001
100000100000100000100000001000000000010000000000010000001
100000100000010000100000001000000000010000000000001000001
100000100000001000100000001000000000010000000000000100001
100000100000000100100000001000000000010000000000000010001
100000100000000010100000001000000000010000000000000001001
100000100000000001000000001000000000010000000000000000101
10000010000000000100000000100000N000010000000000000000011
100000100000000001000000001000000000010000000000000000001
111111100000000001000000001000000000010000000000000000001
100000000000000001000000001000000000010000000000000000001
100000000000000001000000001000000000010000000000000000001
100000000000000001000000001000000000010000000000000000001
100000000000000001000000001000000000010000000000000000001
100000000000000001000000001000000000010000000000000000001
100000000000000001000000001000000000010000000000000000001
100000000000000001000000001000000000010000000000000000001
111111111111111111111111111111111111111111111111111111111
