NO textures/simple_tiles.xpm
SO textures/simple_tiles.xpm
WE textures/simple_tiles.xpm
EA textures/simple_tiles.xpm

F 0,0,1
C 225,30,0

1111111111111111111111111111111111111111111111111111111111111111111111111111111111111111111
1000000000000000000111111111110000000000000000000000000000000000111111111110000000000000001
1000000000000000000110000001110000000000000000000000000000000000110000001110000000000000001
1001111111000111111110000000110000111111111111111111110000111111110000000110000111111111001
1001000001000100000000000000110000100000000000000000010000100000000000000110000100000001001
1001000001111100000111110000111111100000000000000000011111100000111110000111111100000001001
1001000001000100000100010000000000100000000000000000010000100000100010000000000100000001001
1001000001000100000100011111110000100000000000000000010000100000100011111110000100000001001
1001111111000111111100010000011111100000000000000000011111100000110000000011111100000001001
1000000000000000000000010000000000000000000000000000000000000000000000000000000000000001001
1111111111111111111111111111111111110000000000000000111111111111111111111111111111111111001
1000000000000000000000000000000000000000000000000000000000000000000000000000000000000000001
1000000000000000000111111111111111111111111111111111111111111111111111111111111111111111111
1000000000000000000100000000000000000000000000000000000000000000000000000000000000000000001
1000000000000000000100000000000000000111111111111111111111111111111111110000000000000000001
1000000000000000000100000000000000000100000000000000000000000000000000000000000000000000001
1000000000000000000111111111111111111100000000000000000000000000000000000000000000000000001
1000000000000000000000000000000000000000000000000000000000000000000000000000000000000000001
1000000000000000000000000000000000000111111111111111111111111111111111111111111111111111111
1000000000000000000000000000000000000100000000000000000000000000000000000000000000000000001
1000000000000000000000000000000000000100000000000000000000000000000000000000000000000000001
1000000000000000000000000000000000000111111111111111111111111111111111111111111111111111111
1000000000000000000000000000000000000000000000000000000000000000000000000000000000000000001
1000000000000000000111111111111111111111111111111111111111111111111111111111111111111111111
1000000000000000000100000000000000000000000000000000000000000000000000000000000000000000001
1000000000000000000100000000000000000111111111111111111111111111111111111111111111111111111
1000000000000000000100000000000000000100000000000000000000000000000000000000000000000000001
1000000000000000000111111111111111111100000000000000000000000000000000000000000000000000001
1000000000000000000000000000000000000000000000000000000000000000000000000000000000000000001
1000000000000000000111111111111111111111111111111111111111111111111111111111111111111111111
1000000000000000000100000000000000000000000000000000000000000000000000000000000000000000001
1000000000000000000100000000000000000111111111111111111111111111111111111111111111111111111
1000000000000000000100000000000000000100000000000000000000000000000000000000000000000000001
1000000000000000000111111111111111111100000000000000000000000000000000000000000000000000001
1000000000000000000000000000000000000000000000000000000000000000000000000000000000000000001
1000000000000000000111111111111111111111111111111111111111111111111111111111111111111111111
1000000000000000000100000000000000000000000000000000000000000000000000000000000000000000001
1000000000000000000100000000000000000111111111111111111111111111111111111111111111111111111
1000000000000000000100000000000000000100000000000000000000000000000000000000000000000000001
1000000000000000000111111111111111111100000000000000000000000000000000000000000000000000001
1000000000000000000000000000000000000000000000000000000000000000000000000000000000000000001
1000000000000000000000000000000000000111111111111111111111111111111111111111111111111111111
1000000000000000000000000000000000000100000000000000000000000000000000000000000000000000001
1000000000000000000000000000000000000100000000000000000000000000000000000000000000000000001
1000000000000000000000000000000000000111111111111111111111111111111111111111111111111111111
10000000000000000000000000000000000000000000000000000000000000000000000000000000000000000N1
1111111111111111111111111111111111111111111111111111111111111111111111111111111111111111111
