NO textures/simple_tiles.xpm
SO textures/simple_tiles.xpm
WE textures/simple_tiles.xpm
EA textures/simple_tiles.xpm

F 0,0,1
C 225,30,0

111111
1N0011
100101
101111
111111
