NO textures/simple_tiles.xpm
SO textures/simple_tiles.xpm
WE textures/simple_tiles.xpm
EA textures/simple_tiles.xpm

F 0,0,1
C 225,30,0

11111111111111111111111111111111
10000000000000000000000000000001
10000000001111000000111100000001
10000000110000110001100011000001
10000001000000011000000000100001
10000010000000001000000000010001
10000010000000001000000000010001
10000001000000010000000000100001
10000000110001100000000110000001
10000000001111000000001111000001
10000000000000000000000000000001
10000001111111110001111111110001
10000010000000011001000000001001
10000100000000001110000000000101
10000100000000000110000000000101
1000010N000000000010000000000101
10000100000000000010000000000101
10000010000000000100000000001001
10000010000000001000000000001001
10000001000000010000000000010001
10000000110001100000000001100001
10000000001111000000000011100001
10000000000000000000000000000001
11111111111111111111111111111111
