NO textures/simple_tiles.xpm
SO textures/simple_tiles.xpm
WE textures/simple_tiles.xpm
EA textures/simple_tiles.xpm

F 0,0,1
C 225,30,0

1111111111111111    11111111111111111111111111111111111111111111111111111111111111111
1000000000000001    100000000000000000000000000000000000000000000000000000000000000001
1000000000000001    1000000000000000000000000111111111100000000000000000000000000000001
1000000000000001    10001111111111111100000001        1000111111111111111000000111100001
1000000000000001111100001            100000001        10001            10000001    100001
1000000000000000000000001            100000001        10001           10000001      100001
1000000000000000000000001    11111111100000001        10001          10000001        100001
1000000000000000000000001111110000000000000001        10001         10000001        100001
11111000111111111100000000000000000000000000011111111110001        10000001        100001
    11111        100001111111100000000000000000000000000001111111110000001        100001
                 100001      10000000111111000000000000000000000000000001        100001
                 100001      100000001    10000000000000000000000000000111111111100001
      111111111111000001     100000001    1111111111111111111111000000000000000000001
      1000000000000000001    100010001                         100011111111111100001
      1000000000000000001    100010001                         1001          100001
1111111111111100000000001111110001000111111111111111111111111111001         100001
1111111111111100000000000000000001000000000000000000000000000000001        100001
10000000000000000000000011111111111111111111111111111111111111000001      100001
1000000000000000000000001                                    10011001    100001
11111000000000000000000011111                               1001  1001  100001
    1000000001111111111111111                              1111    1001100001
11111000000001                                                      10000001
1000000N000001                                                       111111
10000000000001
11111111111111
