NO /home/olivier/Documents/dev/42/cube3D/repo/Koikub3D/textures/simple_tiles.xpm
SO /home/olivier/Documents/dev/42/cube3D/repo/Koikub3D/textures/simple_tiles.xpm
WE /home/olivier/Documents/dev/42/cube3D/repo/Koikub3D/textures/simple_tiles.xpm
EA /home/olivier/Documents/dev/42/cube3D/repo/Koikub3D/textures/simple_tiles.xpm

F                           0,100,0
C 1,0,255

111111111111
100001000001
101101001111
101010110001
101001001001
10N001001001
100000110001
111111111111
