NO textures/mon_amour_seg_roy_de_mon_coeur.xpm

SO     ./textures/simple_tiles.xpm
WE                textures/simple_tiles.xpm
EA textures/simple_tiles.xpm

F                           0,100,0
C 1,0,255

111111111111
1N0000000001
100000000001
100000000001
111111111111
