NO                                   ./textures/simple_tiles.xpm
SO     ./textures/simple_tiles.xpm
WE                textures/simple_tiles.xpm
EA textures/simple_tiles.xpm

F                           0,100,0
C 1,0,255

11111111111111111111111
1N000000000000000000001
10000000000000000000001
10000000000001000000001
10000001000000100000001
10000010000000010000001
10000100000000000000001
10000000000000000000001
10000000000111100000001
10000000000000000000001
10000000000000000000001
11111111111111111111111